NO                         ./textures/exit.xpm


WE                                                ./textures/phinn.xpm


SO                                   ./textures/floor.xpm
EA                                                         ./textures/coin.xpm















F                                                       220,100,213
C    225,30,112

1111111111111111111111111
1000000000110000000000001   
1011000001110000000000001  
10010000001000000000000011111111                                                 
111111111011000001110000000000001                                                      
100000000000000111110110111111111                                           
11110111111111111100000010001
11110111111111111101010010001  
11000000110101111100000010001
1000000000N000000000000000011  
10000000000000001101010010001      
1000000111010101110101111000111  
10110111111101011101111110001
10111111111111111111111111111
101
101
111
